2,2,2,2,2,3,3,3,3,3,3,3,3,3,2,2,2,2,2,2,2,2,2,2,2,2,2,2,2,2,2,2,2,2,2,2,2,2,2,2,2,2,2,2,2,2,3,3,3,3,3,3,3,3,3,2,2,2,2,2
2,2,2,2,2,2,3,3,3,3,3,3,2,2,2,2,0,0,0,0,0,0,0,0,0,0,0,0,2,2,2,2,0,0,0,0,0,0,0,0,0,0,0,0,2,2,2,2,3,3,3,3,3,3,2,2,2,2,2,2
2,2,2,6,0,2,2,3,3,0,0,0,0,0,0,0,0,0,0,0,0,0,0,0,0,0,0,0,0,2,2,0,0,0,0,0,0,0,0,0,0,0,0,0,0,0,0,0,0,7,7,3,3,2,2,0,6,2,2,2
2,2,6,0,0,0,0,0,0,0,0,0,0,0,0,0,0,0,0,4,4,4,3,3,3,3,3,0,0,0,0,0,0,3,3,3,3,3,4,4,4,0,0,0,0,0,0,0,0,0,0,0,0,0,0,0,0,6,2,2
2,2,0,0,0,0,0,0,0,0,0,0,0,0,0,0,0,0,0,4,4,3,3,0,0,0,3,3,0,0,0,0,3,3,0,0,0,3,3,4,4,0,0,0,0,0,0,0,0,0,0,0,0,0,0,0,0,0,2,2
3,2,0,0,0,0,0,0,0,0,0,0,0,0,0,0,0,0,4,4,3,3,0,0,0,0,0,3,0,0,0,0,3,0,0,0,0,0,3,3,4,4,0,0,0,0,0,0,0,0,0,0,0,0,0,0,0,0,3,2
3,3,2,0,0,0,0,0,0,0,0,0,0,0,0,0,0,4,3,3,3,0,0,0,0,0,0,3,0,0,0,0,3,0,0,0,0,0,0,3,3,3,4,0,0,0,0,0,0,0,0,0,0,0,0,0,0,2,3,3
3,3,3,0,0,0,0,0,0,0,0,0,0,0,0,0,0,0,0,0,0,0,0,0,0,0,3,3,0,0,0,0,3,3,0,0,0,0,0,0,0,7,0,0,0,0,0,0,0,0,0,0,0,0,0,0,0,3,3,3
3,3,3,0,0,0,0,0,0,0,0,0,0,0,0,0,0,0,0,0,0,0,0,0,3,3,3,0,0,0,0,0,0,3,3,3,0,0,0,0,0,0,0,0,0,0,0,0,0,0,0,0,0,0,0,0,0,3,3,3
3,3,0,0,0,0,0,0,0,0,0,4,0,0,0,0,0,0,0,0,0,0,0,0,0,0,0,0,0,0,0,0,0,0,0,0,0,0,0,0,0,0,0,0,0,0,0,0,4,0,0,0,0,0,0,0,0,0,3,3
3,3,0,0,0,0,0,0,0,0,0,4,4,4,0,0,0,0,0,0,0,0,0,0,0,0,0,0,0,0,0,0,0,0,0,0,0,0,0,0,0,0,0,0,0,0,4,4,4,0,0,0,0,0,0,0,0,0,3,3
3,3,0,0,0,0,0,0,4,4,0,6,3,4,4,0,0,0,0,0,0,0,0,0,0,0,2,2,3,3,3,3,2,2,0,0,0,0,0,3,3,0,0,0,0,4,4,3,6,0,4,4,0,0,0,0,0,0,3,3
3,2,0,0,0,0,0,0,0,4,4,3,3,3,3,3,0,0,0,1,5,0,0,0,0,2,2,3,3,4,4,3,3,2,2,0,0,0,0,3,7,0,0,0,3,3,3,3,3,4,4,0,0,0,0,0,0,0,2,3
3,2,0,0,0,0,0,0,0,4,4,4,3,3,2,2,0,0,0,0,1,0,0,0,0,2,3,3,4,4,4,4,3,3,2,0,0,0,0,0,0,0,0,0,2,2,3,3,4,4,4,0,0,0,0,0,0,0,2,3
2,2,0,0,0,0,0,0,0,0,4,4,3,2,2,0,0,0,0,0,0,0,0,0,0,2,3,4,4,0,0,4,4,3,2,0,0,0,0,0,0,0,0,0,0,2,2,3,4,4,0,0,0,0,0,0,0,0,2,2
2,2,0,0,0,0,0,0,0,0,0,4,3,2,0,0,6,0,0,0,0,0,0,0,0,3,3,4,0,0,0,0,4,3,3,0,0,0,0,0,0,0,0,6,0,0,2,0,4,0,0,0,0,0,0,0,0,0,2,2
2,0,0,0,0,0,0,0,0,0,0,0,0,0,0,6,0,0,0,3,2,0,0,0,7,3,0,0,0,0,0,0,0,0,3,0,0,0,0,2,3,0,0,0,6,0,0,0,0,0,0,0,0,0,0,0,0,0,0,2
2,0,0,0,0,4,4,0,0,0,0,0,0,0,0,0,0,0,0,3,2,0,0,0,0,0,0,0,0,7,7,0,0,0,0,0,0,0,0,2,3,0,0,0,0,0,0,0,0,0,0,0,0,4,4,0,0,0,0,2
2,0,0,0,4,4,3,0,0,0,0,0,0,0,0,0,0,0,3,3,2,2,0,0,0,0,0,0,0,0,0,0,0,0,0,0,0,0,2,2,3,3,0,0,0,0,0,0,0,0,0,0,0,3,4,4,0,0,0,2
2,0,0,0,4,4,3,0,0,0,0,3,0,0,0,0,3,3,3,3,3,2,0,0,0,0,0,0,0,0,0,0,0,0,0,0,0,0,2,3,3,3,3,3,0,0,0,0,0,0,0,0,0,3,4,4,0,0,0,2
2,0,0,4,4,3,3,0,0,0,0,3,1,0,0,0,2,2,2,3,6,2,0,0,0,3,2,2,0,0,0,0,2,2,3,0,0,0,2,6,3,2,2,2,0,0,0,0,0,0,0,0,0,3,3,4,4,0,0,2
2,0,0,4,3,3,0,0,0,0,0,0,0,0,0,0,0,0,2,2,2,2,0,0,0,3,3,2,2,0,0,2,2,3,3,0,0,0,2,2,2,2,0,0,0,0,0,0,0,0,0,0,0,0,3,3,4,0,0,2
2,0,0,3,3,0,0,0,0,0,0,0,0,0,0,0,0,0,0,0,0,0,0,0,0,2,3,2,2,2,2,2,2,3,2,0,0,0,0,0,0,0,0,0,0,0,0,0,0,0,0,0,0,0,7,3,3,0,0,2
2,0,0,3,0,0,0,0,0,0,0,0,0,0,0,0,0,0,0,0,0,0,0,0,0,2,3,3,2,2,2,2,3,3,2,0,0,0,0,0,0,0,0,0,0,0,0,0,0,0,0,0,0,0,0,7,3,0,0,2
2,0,0,3,0,6,0,0,3,0,0,0,0,0,0,0,0,0,0,0,0,0,0,0,0,0,0,3,3,2,2,3,3,0,0,0,0,0,0,0,0,0,0,0,0,0,0,0,0,0,0,3,0,0,6,0,3,0,0,2
2,0,0,3,0,0,0,0,3,0,0,0,2,2,2,3,3,0,0,0,3,3,2,2,0,0,0,0,3,2,2,3,0,0,0,0,2,2,3,3,0,0,0,3,3,2,2,2,0,0,0,3,0,0,0,0,3,0,0,2
2,0,0,3,3,0,0,3,3,0,0,2,2,3,3,3,0,0,0,0,2,3,3,3,0,0,0,0,2,2,2,2,0,0,0,0,3,3,3,2,0,0,0,0,3,3,3,2,2,0,0,3,3,0,0,3,3,0,0,2
2,0,0,0,3,3,3,3,0,0,0,2,3,3,4,4,0,0,0,0,2,2,2,3,3,0,0,0,0,0,0,0,0,0,0,3,3,2,2,2,0,0,0,0,4,4,3,3,2,0,0,0,3,3,3,3,0,0,0,2
2,2,0,0,0,0,0,0,0,0,0,3,3,4,4,0,0,0,0,0,0,2,2,2,3,3,2,0,0,0,0,0,0,2,3,3,2,2,2,0,0,0,0,0,0,4,4,3,3,0,0,0,0,0,0,0,0,0,2,2
2,2,2,0,0,0,0,0,0,0,0,3,4,4,0,0,0,6,0,0,0,0,2,2,2,2,2,0,0,0,0,0,0,2,2,2,2,2,0,0,0,0,6,0,0,0,4,4,3,0,0,0,0,0,0,0,0,2,2,2
2,2,2,0,0,0,0,0,0,0,0,3,4,4,0,0,0,6,0,0,0,0,2,2,2,2,2,0,0,0,0,0,0,2,2,2,2,2,0,0,0,0,6,0,0,0,4,4,3,0,0,0,0,0,0,0,0,2,2,2
2,2,0,0,0,0,0,0,0,0,0,3,3,4,4,0,0,0,0,0,0,2,2,2,3,3,2,0,0,0,0,0,0,2,3,3,2,2,2,0,0,0,0,0,0,4,4,3,3,0,0,0,0,0,0,0,0,0,2,2
2,0,0,0,3,3,3,3,0,0,0,2,3,3,4,4,0,0,0,0,2,2,2,3,3,0,0,0,0,0,0,0,0,0,0,3,3,2,2,2,0,0,0,0,4,4,3,3,2,0,0,0,3,3,3,3,0,0,0,2
2,0,0,3,3,0,0,3,3,0,0,2,2,3,3,3,0,0,0,0,2,3,3,3,0,0,0,0,2,2,2,2,0,0,0,0,3,3,3,2,0,0,0,0,3,3,3,2,2,0,0,3,3,0,0,3,3,0,0,2
2,0,0,3,0,0,0,0,3,0,0,0,2,2,2,3,3,0,0,0,3,3,2,2,0,0,0,0,3,2,2,3,0,0,0,0,2,2,3,3,0,0,0,3,3,2,2,2,0,0,0,3,0,0,0,0,3,0,0,2
2,0,0,3,0,6,0,0,3,0,0,0,0,0,0,0,0,0,0,0,0,0,0,0,0,0,0,3,3,2,2,3,3,0,0,0,0,0,0,0,0,0,0,0,0,0,0,0,0,0,0,3,0,0,6,0,3,0,0,2
2,0,0,3,0,0,0,0,0,0,0,0,0,0,0,0,0,0,0,0,0,0,0,0,0,2,3,3,2,2,2,2,3,3,2,0,0,0,0,0,0,0,0,0,0,0,0,0,0,0,0,0,0,0,0,0,3,0,0,2
2,0,0,3,3,0,0,0,0,0,0,0,0,0,0,0,0,0,0,0,0,0,0,0,0,2,3,2,2,2,2,2,2,3,2,0,0,0,0,0,0,0,0,0,0,0,0,0,0,0,0,0,0,0,0,3,3,0,0,2
2,0,0,4,3,3,0,0,0,0,0,0,0,0,0,0,0,0,2,2,2,2,0,0,0,3,3,2,2,0,0,2,2,3,3,0,0,0,2,2,2,2,0,0,0,0,0,0,0,0,0,0,0,0,3,3,4,0,0,2
2,0,0,4,4,3,3,0,0,0,0,1,1,0,0,0,2,2,2,3,6,2,0,0,0,3,2,2,0,0,0,0,2,2,3,0,0,0,2,6,3,2,2,2,0,0,0,1,1,0,0,0,0,3,3,4,4,0,0,2
2,0,0,4,4,4,3,7,0,0,0,1,0,0,0,0,3,3,3,3,3,2,0,0,0,0,0,0,0,0,0,0,0,0,0,0,0,0,2,3,3,3,3,3,0,0,0,0,5,0,0,0,0,3,4,4,4,0,0,2
2,0,0,0,4,4,3,7,0,0,0,0,0,0,0,0,0,0,3,3,2,2,0,0,0,0,0,0,0,0,0,0,0,0,0,0,0,0,2,2,3,3,0,0,0,0,0,0,0,0,0,0,0,3,4,4,0,0,0,2
2,0,0,0,0,4,4,0,0,0,0,0,0,0,0,0,0,0,0,3,2,0,0,0,0,0,0,0,0,6,6,0,0,0,0,0,0,0,0,2,3,0,0,0,0,0,0,0,0,0,0,0,0,4,4,0,0,0,0,2
2,0,0,0,0,0,0,0,0,0,0,0,0,0,0,6,0,0,0,3,2,0,0,0,0,3,0,0,0,0,0,0,0,0,3,0,0,0,0,2,3,0,0,0,6,0,0,0,0,0,0,0,0,0,0,0,0,0,0,2
2,2,0,0,0,0,0,0,0,0,0,4,0,2,0,0,6,0,0,0,0,0,0,0,0,3,3,4,0,0,0,0,4,3,3,0,0,0,0,0,0,0,0,6,0,0,2,3,4,0,0,0,0,0,0,0,0,0,2,2
2,2,0,0,0,0,0,0,0,0,4,4,3,2,2,0,0,0,0,0,0,0,0,0,0,2,3,4,4,0,0,4,4,3,2,0,0,0,0,0,0,0,0,0,0,2,2,3,4,4,0,0,0,0,0,0,0,0,2,2
3,2,0,0,0,0,0,0,0,4,4,4,3,3,2,2,0,0,0,0,0,0,0,0,0,2,3,3,4,0,0,4,3,3,2,0,0,0,0,0,0,0,0,0,2,2,3,3,4,4,4,0,0,0,0,0,0,0,2,3
3,2,0,0,0,0,0,0,0,4,4,3,3,3,3,3,0,0,0,0,5,0,0,0,0,2,2,3,3,4,4,3,3,2,2,0,0,0,0,5,0,0,0,0,3,3,3,3,3,4,4,0,0,0,0,0,0,0,2,3
3,3,0,0,0,0,0,0,4,4,0,6,3,4,4,4,0,0,0,1,5,0,0,0,0,0,2,2,3,3,3,3,2,2,0,0,0,0,0,5,5,0,0,0,4,4,4,3,6,0,4,4,0,0,0,0,0,0,3,3
3,3,0,0,0,0,0,0,0,0,0,0,4,4,4,0,0,0,0,0,0,0,0,0,0,0,0,0,0,0,0,0,0,0,0,0,0,0,0,0,0,0,0,0,0,4,4,4,0,0,0,0,0,0,0,0,0,0,3,3
3,3,0,0,0,0,0,0,0,0,0,4,4,4,0,0,0,0,0,0,0,0,0,0,0,0,0,0,0,0,0,0,0,0,0,0,0,0,0,0,0,0,0,0,0,0,4,4,4,0,0,0,0,0,0,0,0,0,3,3
3,3,3,0,0,0,0,0,0,0,0,4,0,0,0,0,0,0,0,0,0,0,0,0,3,3,3,0,0,0,0,0,0,3,3,3,0,0,0,0,0,0,0,0,0,0,0,0,4,0,0,0,0,0,0,0,0,3,3,3
3,3,3,0,0,0,0,0,0,0,0,0,0,0,0,0,0,0,0,0,0,0,0,0,0,0,3,3,0,0,0,0,3,3,0,0,0,0,0,0,0,0,0,0,0,0,0,0,0,0,0,0,0,0,0,0,0,3,3,3
3,3,2,0,0,0,0,0,0,0,0,0,0,0,0,0,0,4,3,3,3,0,0,0,0,0,0,3,0,0,0,0,3,0,0,0,0,0,0,3,3,3,4,0,0,0,0,0,0,0,0,0,0,0,0,0,0,2,3,3
3,2,2,0,0,0,0,0,0,0,0,0,0,0,0,0,0,4,4,4,3,3,0,0,6,0,0,3,0,0,0,0,3,0,0,6,0,0,3,3,4,4,4,0,0,0,0,0,0,0,0,0,0,0,0,0,0,2,2,3
2,2,0,0,0,0,0,0,0,0,0,0,0,0,0,0,0,0,4,4,4,3,3,0,0,0,3,3,0,0,0,0,3,3,0,0,0,3,3,4,4,4,0,0,0,0,0,0,0,0,0,0,0,0,0,0,0,0,2,3
2,2,6,0,0,0,0,0,0,0,0,0,0,0,0,0,0,0,0,4,4,4,3,3,3,3,3,7,0,0,0,0,0,3,3,3,3,3,4,4,4,0,0,0,0,0,0,0,0,0,0,0,0,0,0,0,0,6,2,2
2,2,2,6,0,2,2,3,3,0,0,0,0,0,0,0,0,0,0,0,0,0,0,0,0,0,0,0,0,2,2,0,0,0,0,0,0,0,0,0,0,0,0,0,0,0,0,0,0,0,0,3,3,2,2,0,6,2,2,2
2,2,2,2,2,2,3,3,3,3,3,3,2,2,2,2,0,0,0,0,0,0,0,0,0,0,0,0,2,2,2,2,0,0,0,0,0,0,0,0,0,0,0,0,2,2,2,2,3,3,3,3,3,3,2,2,2,2,2,2
2,2,2,2,2,3,3,3,3,3,3,3,3,3,2,2,2,2,2,2,2,2,2,2,2,2,2,2,2,2,2,2,2,2,2,2,2,2,2,2,2,2,2,2,2,2,3,3,3,3,3,3,3,3,3,2,2,2,2,2